#######################################################################################################################
#######################################################################################################################
#######################################################################################################################
#####################################################PPPPPPPPP#########################################################
####OOOOOOOOO                                                                                                    ######
####OOOOOOOOO                                                                                                    ######
####OOOOOOOOO                                                                                                    ######
####OOOOOOOOO                                                                                                    ######
####OOOOOOOOO                                                                                                    ######
####OOOOOOOOO                        000000000                         000000000                                 ######
####OOOOOOOOO                        OOOOOOOOO                         OOOOOOOOO                                 ######
####OOOOOOOOO                        OOOOOOOOO                         OOOOOOOOO                                 ######
####OOOOOOOOO                        OOOOOOOOO                         OOOOOOOOO                                 ######
####OOOOOOOOO                        OOOOOOOOO                         OOOOOOOOO                                 ######
####OOOOOOOOO                        OOOOOOOOO                         OOOOOOOOO                                 ######
####OOOOOOOOO                        OOOOOOOOO                         OOOOOOOOO                                 ######
####OOOOOOOOO                        OOOOOOOOO                         OOOOOOOOO                                 ######
####OOOOOOOOO                        OOOOOOOOO                         OOOOOOOOO                                 ######
####OOOOOOOOO                        OOOOOOOOO                         OOOOOOOOO                                 ######
####OOOOOOOOO                        OOOOOOOOO                         OOOOOOOOO                                 ######
####OOOOOOOOO                        OOOOOOOOO                         OOOOOOOOO                                 ######
####OOOOOOOOO                        OOOOOOOOO                         OOOOOOOOO                                 ######
####OOOOOOOOO                        OOOOOOOOO                         OOOOOOOOO                                 ######
####OOOOOOOOO                        OOOOOOOOO                         OOOOOOOOO                                 ######
####OOOOOOOOO                                                                                                    P#####
####OOOOOOOOO                                                                                                    P#####
####OOOOOOOOO                                                                                                    P#####
####OOOOOOOOO                                                                                                    P#####
####OOOOOOOOO                                                                                                    P#####
####OOOOOOOOO                                                                                                    P#####
####OOOOOOOOO                                                                                                    P#####
####OOOOOOOOO                        OOOOOOOOO                         OOOOOOOOO                                 ######
####OOOOOOOOO                        OOOOOOOOO                         OOOOOOOOO                                 ######
####OOOOOOOOO                        OOOOOOOOO                         OOOOOOOOO                                 ######
####OOOOOOOOO                        OOOOOOOOO                         OOOOOOOOO                                 ######
####OOOOOOOOO                        OOOOOOOOO                         OOOOOOOOO                                 ######
####OOOOOOOOO                        OOOOOOOOO                         OOOOOOOOO                                 ######
####OOOOOOOOO                        OOOOOOOOO                         OOOOOOOOO                                 ######
####OOOOOOOOO                        OOOOOOOOO                         OOOOOOOOO                                 ######
####OOOOOOOOO                        OOOOOOOOO                         OOOOOOOOO                                 ######
####OOOOOOOOO                        OOOOOOOOO                         OOOOOOOOO                                 ######
####OOOOOOOOO                        OOOOOOOOO                         OOOOOOOOO                                 ######
####OOOOOOOOO                        OOOOOOOOO                         OOOOOOOOO                                 ######
####OOOOOOOOO                        OOOOOOOOO                         OOOOOOOOO                                 ######
####OOOOOOOOO                        000000000                         000000000                                 ######
####OOOOOOOOO                        000000000                         000000000                                 ######
####OOOOOOOOO                        000000000                         000000000                                 ######
####OOOOOOOOO                        000000000                         000000000                                 ######
####OOOOOOOOO                        000000000                         000000000                                 ######
####OOOOOOOOO                                                                                                    ######
####OOOOOOOOO                                                                                                    ######
####OOOOOOOOO                                                                                                    ######
####OOOOOOOOO                                                                                                    ######
####OOOOOOOOO                                                                                                    ######
####OOOOOOOOO                                                                                                    ######
####OOOOOOOOO                                                                                                    ######
####OOOOOOOOO                                                                                                    ######
####OOOOOOOOO                                                                                                    ######
######################################################PPPPPPPP#########################################################
#######################################################################################################################
#######################################################################################################################
#######################################################################################################################
#######################################################################################################################
#######################################################################################################################
#######################################################################################################################
#######################################################################################################################
#######################################################################################################################
#######################################################################################################################
