#######################################################################################################################
#######################################################################################################################
#######################################################################################################################
######################################################PPPPPPPP#########################################################
####OOOOOOOO                                                                                                     ######
####OOOOOOOO                                                                                                     ######
####OOOOOOOO                                                                                                     ######
####OOOOOOOO                                                                                                     ######
####OOOOOOOO                                                                                                     ######
####OOOOOOOO                                                                                                     ######
####OOOOOOOO                                                                                                     ######
####OOOOOOOO                                                                                                     ######
####OOOOOOOO                                                                                                     ######
####OOOOOOOO                                                                                                     ######
####OOOOOOOO                                                                                                     ######
####OOOOOOOO                                                                                                     ######
####OOOOOOOO                        OOOOOOOOOOOOOOOOOO         OOOOOOOOOOOOOOOOOO                                ######
####OOOOOOOO                        OOOOOOOOOOOOOOOOOO         OOOOOOOOOOOOOOOOOO                                ######
####OOOOOOOO                        OOOOOOOOOOOOOOOOOO         OOOOOOOOOOOOOOOOOO                                ######
####OOOOOOOO                        OOOOOOOOOOOOOOOOOO         OOOOOOOOOOOOOOOOOO                                ######
####OOOOOOOO                        OOOOOOOOOOOOOOOOOO         OOOOOOOOOOOOOOOOOO                                ######
####OOOOOOOO                        OOOOOOOOOOOOOOOOOO         OOOOOOOOOOOOOOOOOO                                ######
####OOOOOOOO                        OOOOOOOOOOOOOOOOOO         OOOOOOOOOOOOOOOOOO                                ######
####OOOOOOOO                        OOOOOOOO                            OOOOOOOOO                                ######
####OOOOOOOO                        OOOOOOOO                            OOOOOOOOO                                ######
####OOOOOOOO                        OOOOOOOO                            OOOOOOOOO                                ######
####OOOOOOOO                        OOOOOOOO                            OOOOOOOOO                                ######
####OOOOOOOO                        OOOOOOOO                            OOOOOOOOO                                ######
####OOOOOOOO                        OOOOOOOO                            OOOOOOOOO                                ######
####OOOOOOOO                        OOOOOOOO                            OOOOOOOOO                                ######
####OOOOOOOOOOOOOOOOOOOOOOOOOOOOOOOOOOOOOOOO         OOOOOOOOO          OOOOOOOOO                                ######
####OOOOOOOOOOOOOOOOOOOOOOOOOOOOOOOOOOOOOOOO         OOOOOOOOO          OOOOOOOOO                                ######
####OOOOOOOOOOOOOOOOOOOOOOOOOOOOOOOOOOOOOOOO         OOOOOOOOO          OOOOOOOOO                                ######
####OOOOOOOOOOOOOOOOOOOOOOOOOOOOOOOOOOOOOOOO         OOOOOOOOO          OOOOOOOOO                                ######
####OOOOOOOOOOOOOOOOOOOOOOOOOOOOOOOOOOOOOOOO         OOOOOOOOO          OOOOOOOOO                                ######
####OOOOOOOOOOOOOOOOOOOOOOOOOOOOOOOOOOOOOOOO         OOOOOOOOO          OOOOOOOOO                                ######
####OOOOOOOOOOOOOOOOOOOOOOOOOOOOOOOOOOOOOOOO         OOOOOOOOO          OOOOOOOOO                                ######
####OOOOOOOO                        OOOOOOOO                            OOOOOOOOO                                ######
####OOOOOOOO                        OOOOOOOO                            OOOOOOOOO                                ######
####OOOOOOOO                        OOOOOOOO                            OOOOOOOOO                                ######
####OOOOOOOO                        OOOOOOOO                            OOOOOOOOO                                ######
####OOOOOOOO                        OOOOOOOO                            OOOOOOOOO                                ######
####OOOOOOOO                        OOOOOOOO                            OOOOOOOOO                                ######
####OOOOOOOO                        OOOOOOOO                            OOOOOOOOO                                ######
####OOOOOOOO                        OOOOOOOOOOOOOOOOOO         OOOOOOOOOOOOOOOOOO                                ######
####OOOOOOOO                        OOOOOOOOOOOOOOOOOO         OOOOOOOOOOOOOOOOOO                                ######
####OOOOOOOO                        OOOOOOOOOOOOOOOOOO         OOOOOOOOOOOOOOOOOO                                ######
####OOOOOOOO                        OOOOOOOOOOOOOOOOOO         OOOOOOOOOOOOOOOOOO                                ######
####OOOOOOOO                        OOOOOOOOOOOOOOOOOO         OOOOOOOOOOOOOOOOOO                                ######
####OOOOOOOO                        OOOOOOOOOOOOOOOOOO         OOOOOOOOOOOOOOOOOO                                ######
####OOOOOOOO                        OOOOOOOOOOOOOOOOOO         OOOOOOOOOOOOOOOOOO                                ######
####OOOOOOOO                                                                                                     ######
####OOOOOOOO                                                                                                     ######
####OOOOOOOO                                                                                                     ######
####OOOOOOOO                                                                                                     ######
####OOOOOOOO                                                                                                     ######
####OOOOOOOO                                                                                                     ######
######################################################PPPPPPPP#########################################################
#######################################################################################################################
#######################################################################################################################
#######################################################################################################################
#######################################################################################################################
#######################################################################################################################
#######################################################################################################################
#######################################################################################################################
#######################################################################################################################
#######################################################################################################################