#######################################################################################################################
#######################################################################################################################
#######################################################################################################################
######################################################PPPPPPPP#########################################################
####OOOOOOOOOOOOOOOOOOOOOOOOOOOOOOOOOOOO                                                                OOOOOOOOO######
####OOOOOOOOOOOOOOOOOOOOOOOOOOOOOOOOOOOO                                                                OOOOOOOOO######
####OOOOOOOOOOOOOOOOOOOOOOOOOOOOOOOOOOOO                                                                OOOOOOOOO######
####OOOOOOOOOOOOOOOOOOOOOOOOOOOOOOOOOOOO                                                                OOOOOOOOO######
####OOOOOOOOOOOOOOOOOOOOOOOOOOOOOOOOOOOO                                                                OOOOOOOOO######
####OOOOOOOOOOOOOOOOOOOOOOOOOOOOOOOOOOOO                                                                OOOOOOOOO######
####OOOOOOOOOOOOOOOOOOOOOOOOOOOOOOOOOOOO                                                                OOOOOOOOO######
####OOOOOOOOOOOOOOOOOOOOOOOOOOOOOOOOOOOO                                                                         ######
####OOOOOOOOOOOOOOOOOOOOOOOOOOOOOOOOOOOO                                                                         ######
####OOOOOOOOOOOOOOOOOOOOOOOOOOOOOOOOOOOO                                                                         ######
####OOOOOOOOOOOOOOOOOOOOOOOOOOOOOOOOOOOO                                                                         ######
####OOOOOOOOOOOOOOOOOOOOOOOOOOOOOOOOOOOO                                                                         ######
####OOOOOOOOOOOOOOOOOOOOOOOOOOOOOOOOOOOO                                                                         ######
####OOOOOOOOOOOOOOOOOOOOOOOOOOOOOOOOOOOO                                                                         ######
####OOOOOOOOO                  OOOOOOOOO                                                                         ######
####OOOOOOOOO                  OOOOOOOOO                                                                         ######
####OOOOOOOOO                  OOOOOOOOO                                                                         ######
####OOOOOOOOO                  OOOOOOOOO                                                                         ######
####OOOOOOOOO                  OOOOOOOOO                                                                         ######
####OOOOOOOOO                  OOOOOOOOO                                                                         ######
####OOOOOOOOO                  OOOOOOOOO                                                                         ######
####OOOOOOOOO                  OOOOOOOOO                                                                         ######
####OOOOOOOOO                  OOOOOOOOO                                                                         ######
####OOOOOOOOO                  OOOOOOOOO                                                                         ######
####OOOOOOOOO                  OOOOOOOOO                                                                         ######
####OOOOOOOOO                  OOOOOOOOO                                                                         ######
####OOOOOOOOO                  OOOOOOOOO                                                                         ######
####OOOOOOOOO                  OOOOOOOOO                                                                         ######
####OOOOOOOOO                  OOOOOOOOO                                                                         ######
####OOOOOOOOO                  OOOOOOOOO                                                                         ######
####OOOOOOOOO                  OOOOOOOOO                                                                         ######
####OOOOOOOOO                  OOOOOOOOO                                                                         ######
####OOOOOOOOO                  OOOOOOOOO                                                                         ######
####OOOOOOOOO                  OOOOOOOOO                                                                         ######
####OOOOOOOOO                  OOOOOOOOO                                                                         ######
####OOOOOOOOO                  OOOOOOOOO                                                                         ######
####OOOOOOOOO                  OOOOOOOOO                                                                         ######
####OOOOOOOOO                  OOOOOOOOO                                                                         ######
####OOOOOOOOO                  OOOOOOOOO                                                                         ######
####OOOOOOOOO                  OOOOOOOOO                                                                         ######
####OOOOOOOOOOOOOOOOOOOOOOOOOOOOOOOOOOOO                                                                         ######
####OOOOOOOOOOOOOOOOOOOOOOOOOOOOOOOOOOOO                                                                         ######
####OOOOOOOOOOOOOOOOOOOOOOOOOOOOOOOOOOOO                                                                         ######
####OOOOOOOOOOOOOOOOOOOOOOOOOOOOOOOOOOOO                                                                         ######
####OOOOOOOOOOOOOOOOOOOOOOOOOOOOOOOOOOOO                                                                         ######
####OOOOOOOOOOOOOOOOOOOOOOOOOOOOOOOOOOOO                                                                         ######
####OOOOOOOOOOOOOOOOOOOOOOOOOOOOOOOOOOOO                                                                         ######
####OOOOOOOOOOOOOOOOOOOOOOOOOOOOOOOOOOOO                                                                OOOOOOOOO######
####OOOOOOOOOOOOOOOOOOOOOOOOOOOOOOOOOOOO                                                                OOOOOOOOO######
####OOOOOOOOOOOOOOOOOOOOOOOOOOOOOOOOOOOO                                                                OOOOOOOOO######
####OOOOOOOOOOOOOOOOOOOOOOOOOOOOOOOOOOOO                                                                OOOOOOOOO######
####OOOOOOOOOOOOOOOOOOOOOOOOOOOOOOOOOOOO                                                                OOOOOOOOO######
####OOOOOOOOOOOOOOOOOOOOOOOOOOOOOOOOOOOO                                                                OOOOOOOOO######
####OOOOOOOOOOOOOOOOOOOOOOOOOOOOOOOOOOOO                                                                OOOOOOOOO######
######################################################PPPPPPPP#########################################################
#######################################################################################################################
#######################################################################################################################
#######################################################################################################################
#######################################################################################################################
#######################################################################################################################
#######################################################################################################################
#######################################################################################################################
#######################################################################################################################
#######################################################################################################################