#######################################################################################################################
#######################################################################################################################
#######################################################################################################################
#######################################################################################################################
####                                                                                                             ######
####                                                                                                             ######
####                                                                                                             ######
####                                                                                                             ######
####             #######                                                                        #######          ######
####             #######                                                                        #######          ######
####             #######                                                                        #######          ######
####             #######                                                                        #######          ######
####             #######                                                                        #######          ######
####             #######                                                                        #######          ######
####             #######                                                                        #######          ######
####             #######                                                                        #######          ######
####             #######                                                                        #######          ######
####             #######                                                                        #######          ######
####                                                                                                             ######
####                                                                                                             ######
####                                                                                                             ######
####                                                                                                             ######
####                                                                                                             ######
####                                                                                                             ######
####                                                                                                             ######
####                                                                                                             ######
####                                                                                                             ######
####                                                                                                             ######
####                                                                                                             ######
####                                                                                                             ######
####                                                                                                             ######
####                                                                                                             ######
####                                                                                                             ######
####                                                                                                             ######
####                                                                                                             ######
####                                                                                                             ######
####                                                                                                             ######
####                                                                                                             ######
####                                                                                                             ######
####                                                                                                             ######
####                                                                                                             ######
####                                                                                                             ######
####                                                                                                             ######
####                                                                                                             ######
####                                                                                                             ######
####                                                                                                             ######
####                                                                                                             ######
####                                                                                                             ######
####                                                                                                             ######
####                                                                                                             ######
####                                                                                                             ######
####                                                                                                             ######
####                                                                                                             ######
####                                                                                                             ######
####                                                                                                             ######
####                                                                                                             ######
####                                                                                                             ######
####                                                                                                             ######
######################################################PPPPPPPP#########################################################
#######################################################################################################################
#######################################################################################################################
#######################################################################################################################
#######################################################################################################################
#######################################################################################################################
#######################################################################################################################
#######################################################################################################################
#######################################################################################################################
#######################################################################################################################